#####################
#...#.#...#...#...#.#
#.#.#.#.###.#.#.###.#
#.#...#.....#.......#
#.###.###.#######.###
#.#.......#...#.....#
#######.#.#.#.#.#####
#...#...#...#.#.....#
#.###.#.###########.#
#.#.#.#.#.......#...#
#.#.###.#.#####.###.#
#.............#...#.#
#.#.#.###############
#.#.#...#...#...#.#.#
#.#####.###.#.###.#.#
......#.#.....#.....#
#.###.###.#####.###.#
#.#.#...........#...#
#.#.#####.#.#####.###
#...#.....#.#.......#
#####################
