#########################################
#.#...#.#.........#...............#.....#
#.#.#.#.#######.###.#.#.#########.#.###.#
#...#.......#...#...#.#...#...#.....#...#
#####.###.#.#.#.#####.#.#####.#####.###.#
#.....#.#.#.#.#...#...#.#.#.#.#...#...#.#
#.###.#.#######.#.#.#.###.#.#.#.#########
#.#...#...#.....#...#.....#.#.#.#...#...#
#.###.#.###########.#####.#.#.#.#.#.###.#
#.#...........#.......#.#.#...#.#.#.....#
###.#######.#.#####.###.#.###.#.#.#.#####
#...#.......#...........#...#.#.#.#...#.#
#.#######.#######.###.###.###.#.#.#####.#
#.....#...#.#...#.#.#...#.#.....#.#.....#
#.###.#####.###.###.#.###.#.#.###.#.###.#
#.#.......#.....#.#...#...#.#...#...#...#
#######.#####.###.#.#########.#####.#.#.#
#...#.....#...#.#.....#...#.........#.#.#
#.###.#.#.#.#.#.#.#######.#.###.#.#####.#
#.....#.#...#.#...#.#.#.....#...#.#...#.#
#.#.#.#####.#.###.#.#.#####.#####.#.#####
#.#.#...#...#.#.#.....#...#.#.....#...#.#
#.###.#########.#####.#.#.###.###.#.#.#.#
#.#.....#.#...#.#.......#.#...#...#.#.#.#
###.#####.###.#.#.#.#####.#.###.#####.#.#
#...#.....#...#...#.#.#.#.#...#.....#...#
#.#######.#.#.#.#.###.#.#####.###.#####.#
#...#...#.#.#...#.#.....#.....#...#.#...#
#.#####.#.###.#.###.###.#.#.#.#####.#.###
#...#.......#.#.#.#.#...#.#.#.#...#.....#
#####.###.#.#.###.#.#########.###.#.#####
#.......#.#.#.....#.#.#.#...........#.#.#
#.###.###.#.#####.#.#.#.#.###.#####.#.#.#
#.#.....#.#.#.....#...#.....#.#.....#...#
#######.###.#.#####.#####.#.#####.#####.#
#...#...#.......#.#...#...#.....#.......#
#.###.#####.#####.#.#.#.###.###.###.#.#.#
#.......#...#.#.#...#.....#...#.#...#.#.#
#.###.#.###.#.#.#.#.###.#.#.#.###.#####.#
#.#...#.#.........#.#...#.#.#.#.......#.#
#######################################.#