###########
#.....#...#
#####.###.#
#.........#
#.#.#.###.#
#.#.#.#.#.#
#####.#.#.#
#.....#.#.#
#.###.#.#.#
#...#.#...#
###.#######